*****************************************
*   *     *           *   *     *       *
* * *** * * ***** *** *** * *** * *** ***
* *   * *     *   * *   * * * *     *   *
* *** ********* *** *** * * * ********* *
* *             *     * * * *     *   * *
* *************** *** * * * ***** * * * *
*           *     * *   *       * * *   *
* ********* ***** * *********** * * *** *
* *       *     * *     *   *     *   * *
* ***** ******* * *** * * * ******* * * *
*       *     * *     * * *   *   * * * *
* ***** * *** * ******* * *** * * *** * *
* *   * * *   * * *   *   *   * *     * *
* * * *** * *** * * * ***** *** ******* *
* * *     * *   * * *     *   *       * *
* * ******* * *** * * ******* ******* * *
E *   *   * * *     * *     *   *     * *
***** * * * * * ***** * *** *** * *****H*
*     * *     *     *     *       *     *
*****************************************
