*************************
*E    *   *     *   *   *
* *** * * * *** * * * * *
* *   * * *   * * * * * *
* * *** * *** * * * * * *
* *     *     * * * * * *
* ********* *** * * * * *
*       * *     * * * * *
******* * ***** * * * * *
*     * *     * * * * * *
* *** * ***** * * * *** *
* * * *       * *     * *
* * * ********* ***** * *
*   *           *   *  H*
*************************