*********************
*     *       *   * *
*** * *** *** * * * *
*   *   *   * * * * *
* ***** * * * * * * *
* *   * * * *   *  H*
* * * * *** *** *****
* * *   *   *   *   *
* ***** * ******* * *
*     * *         * *
***** * ***** ***** *
*   * *     *   *   *
* * * ***** ***** ***
* *   *   *     *   *
* ***** * ***** * * *
*   *   *   * * * * *
*** * ***** * * *** *
*   *     * *       *
* ******* * *********
*         *         *
*******E*************
