*****************************************
*       *     *   *           *     *   *
*** *** * *** * *** *** ***** * * *** * *
*   *     * * * *   * *   *     * *   * *
* ********* * * * *** *** ********* *** *
* *   *     * * * *     *             *H*
* * * * ***** * * * *** *************** *
*   * * *       *   * *     *           *
* *** * * *********** * ***** ********* *
* *   *     *   *     * *     *       * *
* * * ******* * * * *** * ******* ***** *
* * * *   *   * * *     * *     *       *
* * *** * * *** * ******* * *** * ***** *
* *     * *   *   *   * * *   * * *   * *
* ******* *** ***** * * * *** * *** * * *
* *       *   *     * * *   * *     * * *
* * ******* ******* * * *** * ******* * *
* *     *   *     * *     * * *   *   * E
* ***** * *** *** * ***** * * * * * *****
*     *       *     *     *     * *     *
*****************************************
