*********E*
*   *     *
* * * *** *
* * * * * *
* *** * * *
*H      * *
***********
