*******E*******
*       *     *
* ***** * * ***
* *   *   *   *
* * ********* *
* *     *   *H*
* ***** * * * *
*     * * *   *
***** * * *** *
*   * * *   * *
* * * * *** * *
* * *   * * * *
* * *** * * ***
* *       *   *
***************
