***E***
*     *
***** *
*     *
* *****
*     *
* *** *
*H  * *
*******

